#################
# ?     ?     ? #
#               #
#               #
# ?     1     ? #
#               #
#               #
# ?     ?     ? #  
#################
# ?     ?     ? #
#               #
#               #
# ?     2     ? #
#               #
#               #
# ?     ?     ? #  
#################
