#################
#1              #
#               #
#               #
#               #
#               #
#               #
#               #
#               #
#               #
#               #
#               #
#               #
#               #
#               #
#              2#
#################
