#################
#1              #
#               #
#               #
#               #
#    xxx xxx    #
#    x?   ?x    #
#       ?       #
#      ?x?      #
#       ?       #
#    x?   ?x    #
#    xxx xxx    #
#               #
#               #
#               #
#              2#
#################
