#################
# # # # # # # # #
#      # #      #
#  # ## #       #
#       ###  ## #
# #   ##1 # # # #
#          #    #
#  #  # #  # #  #
#     #         #
# # # # # # # # #
#          #    #
#  # #  ## # #  #
# #    ##  #    #
# # # # 2## # # #
#       #       #
#  # #  #  # #  #
#################
