#################
# # # # # # # # #
#               #
#? # #  #  # # ?#
#               #
# # # # 1 # # # #
#               #
#  # #  #  # #  #
#       ?       #
# # # # # # # # #
#       ?       #
#? # #  #  # # ?#
#               #
# # # # 2 # # # #
#               #
#  # #  #  # #  #
#################
