#################
# # # # # # # # #
#      # #      #
#? # #  #  # # ?#
#     # # #     #
# # # # 1 # # # #
#     #####     #
#  # #  #  # #  #
#       ?       #
# # # # # # # # #
#       ?  #    #
#? # #  ## # # ?#
#      #   #    #
# # # ##2## # # #
#       #       #
#  # #  #  # #  #
#################
