#################
# ?     ?     ? #
#               #
#               #
# ?     1     ? #
#               #
#               #
# ?     ?     ? #
#################
# ?     ?     ? #
#               #
#               #
# ?           ? #
# x##           #
#   #           #
# @2#   ?     ? #
#################
